**********************
*....................*
*.........*..........*
**********************
*.........*..........*
*.........*..........*
*....................*
**********************